1111111111
1PEC1111C1
1000000001
1111111111