111111111111111
1P0C1111C1111C1
101010000100001
101010100101111
101010100100001
100010100111101
1E1000100000001
111111111111111