111111111111111
1P00C00000000E1
1000C0111101001
1000C01C0001001
1000C0111111001
1000C0000000001
111111111111111
