1111111111111111111111111111111111111
1E001000100010001P0010001000100010001
1C00101010101010101010101010101010101
1000001000100010101010101010101010101
1000100010001000101010101010101010101
1C00101010101010101010101010101010101
10000010001000100010001000100010001C1
1111111111111111111111111111111111111