11111111111
10010000001
1P0100000C1
10010000001
11111111111