11111111111111111111111111
10010000000C000000CC111111
100001111100CCCCC000011111
1P0011E00000CCC00000000111
11111111111111111111111111