11111111111
10000E00001
1P000E000C1
10000E00001
11111111111