11111111111111111111
1P1C0000000001111111
10111111011111111111
10000000011111111111
10111101111111111111
10100001111111111111
10101011111111111111
10001011111111111111
11100111111111111111
1C110011111111111111
10100111111111111111
10101111111111111111
10100111111111111111
10110111111111111111
10000011111111111111
11111011111111111111
11101011111111111111
11101010111111111111
1E000000000000001011
11111111111111111111