11111111111
1EPC0000001
1CCC0001101
1CCCCCCCCC1
10011001111
11111111111