11111111111111111111111111
10010000000C00000000000001
10000111110000000000000001
100011E0000000000000000001
10000000000000000000000001
10001110000010001000000001
10000000000011011000000001
100000000000010100000000P1
11111111111111111111111111