1111111111111
10PCE00000001
100000000C001
100C000000001
1111111111111